1111111111111
1000000000001
1C000C0000001
100000E000001
10000P0000001
1111111111111